//1,2,3,4,5,6,7,8,9,10,11,12,13,14,15,16,17,18,19,20,21,22,23,24,25,26,27,28,29,30,31,32
0,0,0,0,0,0,99,0,0,0,0,0,0,0,0,0,0,0,0,0,0,0,0,0,0,0,0,0,0,0,0,0
0,100,100,100,0,100,100,100,0,0,0,0,0,100,100,100,0,100,0,100,0,0,0,0,0,0,0,0,0,0,0,0
0,0,0,100,0,0,0,100,0,100,0,100,0,0,0,100,0,100,0,100,0,0,0,0,0,0,0,0,0,0,2,0
0,0,100,100,0,0,100,0,0,0,100,0,0,0,100,0,0,100,100,100,0,0,0,0,0,0,0,0,0,100,100,100
0,0,0,100,0,100,0,0,0,100,0,100,0,100,0,0,0,0,0,100,0,0,0,0,0,0,0,0,0,0,0,0
0,100,100,100,0,100,100,100,0,0,0,0,0,100,100,100,0,0,0,100,0,0,0,0,0,0,0,0,0,0,0,0
0,0,0,0,0,0,0,0,0,0,0,0,0,0,0,0,0,0,0,0,0,0,0,0,0,0,0,0,2,0,0,0
0,0,0,0,0,0,0,0,0,0,0,0,0,0,0,0,0,0,0,0,0,0,0,0,0,0,0,100,100,100,0,0
0,100,0,32,0,0,0,302,0,0,100,0,0,0,0,0,0,0,0,0,0,0,0,0,0,0,0,0,0,0,0,0
0,0,100,100,100,100,100,100,100,100,0,0,0,0,0,0,0,0,0,0,0,0,0,0,2,0,0,0,0,0,0,0
0,0,0,0,0,0,0,0,0,0,0,0,0,107,0,0,0,0,0,0,0,0,0,100,100,100,0,0,0,0,0,0
0,0,0,0,0,0,0,0,0,0,0,0,100,100,100,0,0,0,0,0,0,0,0,0,0,0,0,0,0,0,0,0
0,0,0,0,0,0,0,0,0,302,0,0,0,0,0,0,100,100,100,0,0,0,0,0,0,0,0,0,0,0,0,0
0,0,0,0,0,0,0,0,0,107,302,0,0,0,0,0,0,0,0,0,2,0,100,0,0,0,0,0,0,0,0,0
0,0,0,0,0,0,0,0,100,100,100,0,0,0,0,0,0,0,0,100,100,100,100,0,0,0,0,0,0,0,0,0
0,0,0,2,30,0,0,0,0,0,0,0,0,0,0,0,0,0,0,0,0,0,0,0,0,0,0,0,0,0,0,0
0,0,100,100,100,0,0,0,0,0,0,0,0,0,0,0,0,0,0,0,0,0,0,0,0,0,0,0,0,0,0,0
0,200,0,0,0,0,31,0,0,0,0,0,0,0,0,0,0,0,0,0,0,0,0,0,0,0,0,0,0,0,0,0
100,0,0,0,0,302,100,0,41,302,33,0,100,107,0,0,20,0,100,0,0,10,0,0,100,0,0,0,0,0,0,100
100,100,100,100,100,100,100,100,100,100,100,100,100,100,100,100,100,100,100,100,100,100,100,100,100,100,100,100,100,100,100,100
100,100,100,100,100,100,100,100,100,100,100,100,100,100,100,100,100,100,100,100,100,100,100,100,100,100,100,100,100,100,100,100
100,100,100,100,100,100,100,100,100,100,100,100,100,100,100,100,100,100,100,100,100,100,100,100,100,100,100,100,100,100,100,100
100,100,100,100,100,100,100,100,100,100,100,100,100,100,100,100,100,100,100,100,100,100,100,100,100,100,100,100,100,100,100,100
101,101,101,101,101,101,101,101,101,101,101,101,101,101,101,101,101,101,101,101,101,101,101,101,101,101,101,101,101,101,101,101
